%%%%%%%%%%%%%%%%%%%%%%%%%%%%%%%%%%%%
%P                                 %
% %%%%%%%%%%%%%%%%%       %%%%%%%% %
% %    %   %      %         %      %
% %  % % % % %%%% %%%%%%%%% %  %%%%%
% %  % % % %              % %      %
% %  % % % % % %%%%  %      %%%%%% %
% %  % % %   %    %  %%%%%%%%      % 
% %  % % %%%%%%%% %         %  %%%%%
% %  %   %        %%%%%%%%% %      %
%    %%%%%  %%%%%%%       % %%%%%% %
%%%%%%      %       %%%%  % %      %
%      %%%%%% %%%%% %     % %  %%%%%
% %%%%%%      %           % %      %
%        %%%%%% %%%%%%%%%%% %    % %
%%%%%%%%%%                  %%%%%% %
%           %%%%%%%%%%%%%%%        %
% %% %    %                 %      %
%.   %    %                 %      %
%%%%%%%%%%%%%%%%%%%%%%%%%%%%%%%%%%%%